Israel	Dougherty	Texas	Austin
Barrett	Morrison	Texas	Dallas
Britney	Hobbs	Texas	Houston
Enrique	Vang	Texas	San Antonio
Nico	Todd	Texas	Ft. Worth
Kaylee	Kirk	Texas	Austin
Alice	Huynh	Texas	Dallas
Shirley	Hill	Texas	Houston
Josue	Carter	Texas	San Antonio
Kingston	Stout	Texas	Ft. Worth
Kolton	Chaney	Ohio	Cleveland
Finn	Herman	Ohio	Akron
Preston	Lam	Ohio	Cincinnati
Gunner	Khan	Ohio	Toledo
Damien	Conrad	Ohio	Kent
Isaias	Miller	Ohio	Cleveland
Josie	Reilly	Ohio	Akron
Dorian	Graves	Ohio	Cincinnati
Alayna	Blair	Ohio	Toledo
Destiny	Ferrell	Ohio	Kent
Aurora	Clayton	Georgia	Atlanta
Antony	Aguilar	Georgia	Augusta
Cash	Prince	Georgia	Columbus
Kylie	Tate	Georgia	Macon
Kayleigh	Rivers	Georgia	Athens
Jeramiah	Berry	Georgia	Atlanta
Leonard	Morgan	Georgia	Augusta
Hadassah	Donovan	Georgia	Columbus
Pranav	Farley	Georgia	Macon
Quinn	Sharp	Georgia	Athens
Darian	Trevino	Virginia	Richmond
Stanley	Garza	Virginia	Norfolk
Cruz	Schneider	Virginia	Alexandria
Amiya	Dixon	Virginia	Arlington
Ashton	Stokes	Virginia	Hampton
Shayna	Velasquez	Virginia	Richmond
Cash	Glover	Virginia	Norfolk
Camryn	Perez	Virginia	Alexandria
Trent	Underwood	Virginia	Arlington
Jaylan	Vang	Virginia	Hampton
Kallie	Barajas	New York	Albany
Trace	Stanley	New York	Brooklyn
Brycen	Skinner	New York	Harlem
Jermaine	Galvan	New York	Bronx
Saniyah	Salas	New York	Manhattan
Heather	Callahan	New York	Albany
Jace	Patel	New York	Brooklyn
Alissa	Hood	New York	Harlem
Asia	Barrett	New York	Bronx
Eleanor	Wiggins	New York	Manhattan
Olive	Holder	Alabama	Burmingham
Jillian	Bailey	Alabama	Huntsville
Aimee	Mcdowell	Alabama	Montgomery
Paula	Massey	Alabama	Mobile
Luz	Mcdaniel	Alabama	Hoover
Kadyn	Carson	Alabama	Burmingham
Mason	Berg	Alabama	Huntsville
Nelson	Bowers	Alabama	Montgomery
Elle	Shields	Alabama	Mobile
Fisher	Schmidt	Alabama	Hoover
Ramon	Blake	Maryland	Baltimore
Sasha	Hebert	Maryland	Columbia
Conner	Chang	Maryland	Silver Spring
Brady	Mora	Maryland	Waldorf
Barrett	Reeves	Maryland	Germantown
Zaid	Krause	Maryland	Baltimore
Glenn	Simon	Maryland	Columbia
India	Wheeler	Maryland	Silver Spring
Savannah	Reeves	Maryland	Waldorf
Miley	Arias	Maryland	Germantown
Gavin	Herman	Mississippi	Jackson
Ruth	Bradley	Mississippi	Forest
Marcos	Sullivan	Mississippi	Biloxi
Kenneth	Navarro	Mississippi	Vicksburg
Jasmin	Thompson	Mississippi	Tupelo
Ryan	Hines	Mississippi	Jackson
Lance	Levy	Mississippi	Forest
Dominic	Arias	Mississippi	Biloxi
Anna	Brooks	Mississippi	Vicksburg
Mohammed	Lewis	Mississippi	Tupelo
Raven	Hodges	Florida	Jacksonville
Uriah	Moss	Florida	Miami
Carleigh	Pollard	Florida	Tampa
Avah	Lowery	Florida	Orlando
Leila	Kelly	Florida	Tallahassee
Jadiel	Kaufman	Florida	Jacksonville
Alivia	Summers	Florida	Miami
Amiya	Hernandez	Florida	Tampa
Alia	Alvarado	Florida	Orlando
Marisol	Michael	Florida	Tallahassee
Emelia	Mckee	Louisiana	New Orleans
Jovanny	Mcguire	Louisiana	Baton Rouge
Savanah	Dyer	Louisiana	Shreveport
Blaine	Simmons	Louisiana	Lafayette
Maverick	Becker	Louisiana	Monroe
Lola	Maxwell	Louisiana	New Orleans
Paulina	Rodgers	Louisiana	Baton Rouge
Rogelio	Kline	Louisiana	Shreveport
Alexandra	Bell	Louisiana	Lafayette
Vincent	Rice	Louisiana	Monroe